# Syntax Coloring Map For '.'

# Datatypes (KEYWORD1)
long_enum_e	KEYWORD1
ChildishClassbino	KEYWORD1

# Functions (KEYWORD2)
ChildishClassbino	KEYWORD2
high_five	KEYWORD2
c_function	KEYWORD2

# Structures (KEYWORD3)
shorty_base_t	KEYWORD3

# Constants (LITERAL1)
TYPICAL_INCLUDE_GUARD_H	LITERAL1
DEFAULT_NOMS	LITERAL1
ENUM_VAL_0	LITERAL1
ENUM_VAL_1	LITERAL1
ENUM_VAL_2	LITERAL1
ENUM_VAL_3	LITERAL1
ENUM_VAL_4	LITERAL1
ENUM_VAL_NUM	LITERAL1

# Properties (LITERAL2)
console	LITERAL2
waypoint	LITERAL2
maiBino	LITERAL2
mysterious_var	LITERAL2
